########
>  #   #
## # ###
#      =
########